"a" = (/turf/unsimulated/hellwall,/area/space)
"b" = (/turf/simulated/floor/helldirt,/area/space)
"c" = (/obj/structure/flora/ausbushes/hellgrass3,/turf/simulated/floor/helldirt,/area/space)
"d" = (/obj/structure/flora/ausbushes/hellgrass2,/turf/simulated/floor/helldirt,/area/space)
"e" = (/obj/structure/flora/ausbushes/hellgrass,/turf/simulated/floor/helldirt,/area/space)
"f" = (/turf/unsimulated/wall/supermatter/hell,/area/space)
"g" = (/turf/simulated/floor/hellslate,/area/space)
"h" = (/turf/unsimulated/mineral,/area/space)
"i" = (/obj/structure/flora/tree/hell,/turf/simulated/floor/helldirt,/area/space)
"j" = (/obj/structure/flora/tree/plant,/turf/simulated/floor/helldirt,/area/space)
"k" = (/obj/item/remains/human,/turf/simulated/floor/helldirt,/area/space)
"l" = (/obj/item/remains/mouse,/turf/simulated/floor/helldirt,/area/space)
"m" = (/obj/item/remains/xeno,/turf/simulated/floor/helldirt,/area/space)
"n" = (/obj/structure/flora/ausbushes/hellgrass4,/turf/simulated/floor/helldirt,/area/space)
"o" = (/obj/old_god_shrine/xom_shrine,/turf/simulated/floor/helldirt,/area/space)
"p" = (/turf/unsimulated/wall/cult,/area/space)
"q" = (/obj/structure/rubble/war,/turf/simulated/floor/helldirt,/area/space)
"r" = (/obj/structure/fishwall,/turf/simulated/floor/hellslate,/area/space)
"s" = (/obj/structure/table/rack/ruintable,/turf/simulated/floor/hellslate,/area/space)
"t" = (/obj/structure/closet/coffin,/turf/simulated/floor/hellslate,/area/space)
"u" = (/obj/structure/noticeboard,/turf/unsimulated/wall/cult,/area/space)
"v" = (/obj/structure/sign/kalendar1,/turf/unsimulated/wall/cult,/area/space)
"w" = (/obj/structure/curtain/black,/turf/simulated/floor/hellslate,/area/space)
"x" = (/obj/structure/deity/blood_forge,/turf/simulated/floor/hellslate,/area/space)
"y" = (/obj/structure/throne/countess,/turf/simulated/floor/hellslate,/area/space)
"z" = (/obj/structure/body3,/turf/simulated/floor/helldirt,/area/space)
"A" = (/obj/structure/kitchenspike,/turf/simulated/floor/hellslate,/area/space)
"B" = (/obj/structure/woodenclock,/turf/simulated/floor/hellslate,/area/space)
"C" = (/obj/structure/mirror/raider,/turf/unsimulated/wall/cult,/area/space)
"D" = (/obj/structure/sink/puddle,/turf/simulated/floor/helldirt,/area/space)
"E" = (/mob/living/simple_animal/alien2,/turf/simulated/floor/helldirt,/area/space)
"F" = (/obj/effect/spider/stickyweb,/turf/simulated/floor/hellslate,/area/space)
"G" = (/obj/structure/body2,/turf/simulated/floor/helldirt,/area/space)
"H" = (/obj/structure/gravemarker/cross,/turf/simulated/floor/helldirt,/area/space)
"I" = (/obj/structure/body1,/turf/simulated/floor/helldirt,/area/space)
"J" = (/obj/structure/rubble,/turf/simulated/floor/helldirt,/area/space)
"K" = (/obj/structure/rubble/house,/turf/simulated/floor/helldirt,/area/space)
"L" = (/obj/machinery/washing_machine,/turf/simulated/floor/helldirt,/area/space)

(1,1,1) = {"
aaaaaaaaaaaaaaaaaaaaaaaaaaaaaaaaaaaaaaaaaaaaaaaaaaaaaaaaaaaaaaaaaaaaaaaaaaaaaaaaaaaaaaaaaaaaaaaaaaaa
ahhhhhhhhhhhhhbbffbbbbbbbbbbbbbbbbhhhhhhhhhhhhhhhhhhhhhhhhhhhhhhhhbbbbbbbbbbbbbbbbbbhhhhhhhhhhhhhhha
ahhhhhhhhhhhhhbbbffbbibbbbbbbbbbbbhhhhhhhhhhhhhhhhhhhhhhhhhhhhhhhhbbbbbbbbbbnnnnnnnbhhhhhhhhhhhhhhha
ahhhhhhhhhhhhhbcbbfbbbbjbbhhhbebbbbhhhhhhhhhhhhhhhhhhhhhhhhhhhhhhbbbbbbbbnnnnnnnnnnbhhhhhhhhhhhhhhha
ahhhhhhhhhhhhhbbbbfffbbbhhhhhhbbdbbhhhhhhhhhhhhhhhhhhhhhhhhhhhhhhbbbbbbbcbbbnnnnnnnhhhhhhhhhhhhhhhha
ahhhhhhhhhhhhhbbbbbbffbchhhhhhhbbbbhhhhhhhhhhhhhhhhhhhhhhhhhhhhbbbbbeebbbbbbobbnnbhhhhhhhhhhhhhhhhha
ahhhhhhhhhhhhhhbibdbbfbbhhhhhhhbbbbbhhhhhhhhhhhhhhhhhhhhhhhhhhbbbeeeebhhhhbbbbbbbbhhhhhhhhhhhhhhhhha
ahhhhhhhhhhhhhhkbbbbbfbbbhhhhhbbbbbbhhhpppppppppppphhhhhhhhhhbbbeeebehhhhhhbbcbqqbhhhhhhhhhhhhhhhhha
ahhhhhhhhhhhhhhbbnnnbfbkbbhhbbnbibbbhhhpggpgggpgrgppppppphhhhbbbeebbhhhhhhhbbbbqbbbhhhhhhhhhhhhhhhha
ahhhhhhhhhhhhhbbnnnnbfbbebbbbnnbbbbbbhhpggggggpgsgptgggtphhhhbbbbbbhhhhhhhhbbbbbbbbhhhhhhhhhhhhhhhha
ahhhhhhhhhhhhhbbnnnnbfebbbbbbbbbbbbnbhhpgppgggpgggptgggtphhhbbibbbhhhhhhhbbnnnbbbbbbhhhhhhhhhhhhhhha
ahhhhhhhhhhhhbbbnnbbbfbbffffbbebcnnnbbhpggppguvpwpptgggtphhbbbbbbhhhhhhhbbnnnbbibcbbbhhhhhhhhhhhhhha
ahhhhhhhhhhhbbjbbbbbbffffbbffffbbnnnbbhpggpxggygggppwpppphbbbbbbhhhhhhbbbnnnnbbbbbbbbbhhhhhhhhhhhhha
ahhhhhhhhhhbnnbbbbbfffbbbbbbbbffbbbbhhhppgggggggggggggphhhnnnbbhhhhhhbbbbbbeeebbbbzbbbbbhhhhbhhhhhha
ahhhhhhhhhbnnbbbbbffbbbbbjbbbbbfbbbhhhhpAgpggggggBpgggChbnnbnbhhhhhbbbcbbbbbbebbbbbbbbnnbhhbbbbbhhha
ahhhhbhhhbnnbbbibbfbbbbbbbebbbbfbbbhhhhpppppppgppppppgphbnbnnbhhhhbbbbbbffffffffffbbebennbbffffffffa
abbbbbbbbbnbbbbbbffbbbbfffbbibbfbbbhhhhhhhhhhpgphhhpggphbnbcbhhhhbzbbbbffffffffffffbbbbbnbffbhhhbbba
abbcbbbbbbDbbcbbbfbbqbffbfbbbbffbbbbhhhhhhhhhpgphhhpggphhbbbhhhhbbbbbfffffffffffffffbbibbffbhhhhbbba
abbbbbbbbbbEbbbbbfbqqbfbbbbdbbfbbbjbbhhhhhhhhpFphhhpggphhbbbbhhbbbbbffffffffffffffffebbbffbhhhhhbiea
abbbbbhhhbbbbbbbbfbbbbfbbbbbbffbbbbbbGhhhhhhhbbbhhhpppphhbbbbbbbbbbfffffffffffffffffbbbbfbbbhhhhbbba
abbbbhhhhhhbbbkbffbbcbfbbbbbffbbqqbbbbhhhhhhbbbbbbhhhhhhbbjbbbbbbbbfffffffffffffffffbfffffbbbbbcnnba
abbbbhhhhhhbbbbbfbbbbbffbbbffbbbbqbbcbbebbbbbbcbbbhhhhhhbebbibbHbbbfffffffbbzfffffffffbbbfffffffenba
abbbhhhhhhbbHbbbfbbbbbbfffffbbbbbbkbbbbebnnnbbbbbhhhhhhheebbbbbbbbfffffffbibbfffffffbbbbhhhhhhbffffa
abbbhhhhhbbbbbfffbbbbnnnbbbbbbibbbbbbbbbnnnnnbbbhhhhhhhhebbbbbffffffffffffbbfffffffbbbbhhhhhhhhbbbba
abbbhhhhbqbbbffbffbbbbbnnnbbbbbbbbbbbbbznnnbbbbhhhhhhhhhbbbfffffffffffffffffffffffbzbchhhhhhhhhbbbba
abbbbhhbqbbbffbbbffbbbbbbnbbbfffffffffbbbbbbbbbhhhhhhhhbbbffffffbbbfffffffffffffffbbbbhhhhhhhhhbbbba
abbbbbbbbbbffbffbbfbbbhhbbbbffbbbbbbbffffffbbbbhhhhhhbbbbbffffbbbbkbffffffffffffffbebbhhhhhhhhhbbbba
abbkbbbbbbbfbbfffbfbbhhhhbbffbbbbHbEbbbbbbfggbbbhhhhbbbbbffffbbbbbbbbffffffffffffffbnnbhhhhhhhhbbbba
abbbbcbbibbfbbfbfbfbhhhhhbbfbbnnbbbbbbbbibbggbbbbbbbbbbbbfffbbbbjbibbbbfffffffffffffbnnbhhhhhhhbbbba
abbbbbbbbbbfbbfbbbfbhhhhhbbfbbnbbjbbnnbbbbbggfbbbbbbbbbbbfffbbcbbbbbbbbbbbbbbbffffffbbnbbhhhhhhbcbba
abbbbbbbbbbfbbfffffbbhhhbbbfbbbbbbbnnbbbeebggffbbbbbbbbbfffbbbbbbbhhhhhbbbbbzbbffffffbnnbbhhhhbbbbba
abbbbbbhhhbffbkbffbbnbhhbbbfbbbbcbnnffffbbbbbbfffbbbbfffffbeebbbhhhhhhhhhbbbbbbfffffffbbbqqbbbbbbeba
abbbbbhhhhhbfbbbbbbbnnbbbbbfbbibbbbffbbffbbkbbbbfffffffffbbbeebbhhhhhhhhhhhbbbbbfffffffbbbqbbbibbnba
abbbbhhhhhhbffbbbbcbbnbbbdbfbbbbbbffbbbbffbbcbbbffffbbbbbbbbbbbbhhhhhhhhhhhhebbbbfffffffbbbbHbbnnnba
abbbbhhhhhbbbfbbbbbbbbbbbbbffbbnnbfbbbjbbfbbbbbbbfbbbnnbbbbibbbbbhhbbbbbbhhhhebbbbffffffffbbbennnnba
abbbbbjhhbbbffffffffbbbbbbbbffbbbbbbbbbbffbbbbbbbfbnnnnnnnbbbbbbbhhbbbbbbbhhhhebbbbffffffffbbbnnnnba
abbbbbbbbbfffbbbbbbffbnbbnbbbfffbbbbbbbffbbbbbbbbfbnnnnnnnbbbbbbbbeebbebbbbhhhebbbbbfffffffffbbennba
abbbbbbbbffbbbbbbbbbffbbbnbbbbbfffbbbfffbbbbbbbibfbbbbbbnnbbbibbbbbeeeebbbbbhhbbbHbbbfffbbfffffffbba
abbicbbbbfbbbbfffffbbfbbbbbbbbbbbfffffbbbbbbbbbbffbbcbbbbbbbbbbbbbbbeebbbbbhhhbbjbbbbfffbbbbbffffffa
abbbbbbbffbbbbfbbbfbbffbffffbbbbbfbbbbhhhhqbbbbbfbbbbbbbbbbbbbbbbbbbebbbbbbhhhbbbbbbffffbbbkbbbebbba
abbbbbbbfbbEbbfbbbfbbbfffbbffbbnbfbbhhhhhhbbbbbgggbbbbebbjbbbbbkbbbbbbbbqqhhhhbbbbkbfffbbjbbbbbbbbba
abbqqbbbfbbbbbffcbfbbbffbbbbfbbnbfbhhhhhhIbbbbbgggbbbeebbbbbbbbbbbbbbbbbqhhhhbbbibbbfffbebbhhhhhhbha
abbbHbbbffbbibbfbbfbbkfbbbbffbbnbfbhhhhbbbbbbbbbffbbeeeebbbbbbbbbbbbbbhhhhhhhbbbbbbbfffbcehhhhhbhbha
abbbbbbbbfbbbbzfbbfbbbfbbfffbbbbbfbhhbbbbbbbbzbbfbbbbeebcbbbbbbbbbbhhhhhhhhhbbbbbbffffbebhhhhbbbbbha
affbbnnbbfbzbbbfbbfbibffbbbbbbbbffbbbbbbbbbbbbbffbbbbebbbbbbbbbbbbbhhhhhhhbbbbbbbfffffbbhhhhbbbbbbha
abfbbnnnbffbbzffbbfbbbbfbbbbbbfffbbbbbdbbhhhhbbfbbbbbbbbbbbbbbcbbbhhhhhhhbebebbffffffbbhhhhhhbbeebha
abffbnnnbbfffffbbbfbbbbfffbbfffbbbbbbbbbhhhhhbbfbbbbbbbhhhqbbbbbbbhhhhhhbebbbffffbbbbnbhhhhhhbbebbha
abbfbbbjbbbbbhhhbbfbhhbbbffffbbbbbbbbbbbhhhhhbbfbbbbbhhhhhhhbbbbbbbbhhbbbbbffffbbbbbznbhhhhhhbbbbbha
abbffbbbcbbbhhhhbbfhhhbbbbbbbbbbbbbjbbbhhhhhhbbfbbbhhhhhhhhhbbbbbbebbbbbbbffffbbnnnbbbhhhhhhhhbbbhha
abbbffbbbbbhhhhbbffhhhbHbbbbbbbnbbbbbbbhhhhhbbffbbbhhhhhhhhhbbbbeebbbbbbbfffbbbnnnebbchhhhhhhhhbbhha
abbbbfbbbbbhhhbbffhhhhbbbbbbbbbbbbbbbcbhhhhbbbfbbbbhhhhhhhhhbcbeebbbcbbbffffbHennbbbbbbbbhhhhhhhbhha
abbbbffbbbbbhhbffhhhhbbbbbhhhhhbnbbbbbbhhhhbbffbbbbhhhhhhhhhbbbeebbebbbffffbbbbbbebbbbebbbhhhhhhbhha
abbbbbffffffffffhhhhbbbhhhhhhhhbbbbbbbbbhhbbffbbbnbhhhhhhhhhbbbebibbbbbfffbbbjbbhhhhhbbbbbbhhhhhbbha
abbbbbbbbbhhhhhhhhhbbbhhhhhhhbbbbbbbbbbbbbfffbbbbnnbhhhhhhhhhbbbbbbbbbbffbbebbbhhhhhhhbebbbhhhhhbbha
abbbkbbbbbhhhhhhhhbbbhhhhhhhbbbbbbbbbbbbbffbbbbbbbnbbhhhhhhhhhhbbbbbbbffbbbbbbhhhhhhhhhbbbbhhhhhbbha
abbbbbbbbbbhhhhhbbbbbhhhhhhbbnbbbbbbbbbbffbbbbbbbbbbbbbbbhhhhhhhhbbebbffbbibebhhhhhhhhhbbbbbbbbbbbha
abbbbbibbbbbbbbbbbbbbhhhhhbnnnnbbbbffffffffffffbblbcbbbbbhhhhhhhhhhbbbbbbbbcbbhhhhhhhhhbqeebbbbbbbha
abbbbbbbbbbbbbbbbbbbbhhhhhnnnnbbbbffbbbbbbbbbbfffbbbbbbbbhhhhhhhhhhhbbbbbbbbbhhhhhhhhhbbbbbbbbbbbhha
abbbbbbbbbbbcnnbbbbnbbhhhhnbnbbbbffbbbbbbbbbbbbbffbbbbbbbhhhhhhhhhhhhbbbbbbhhhhhhhhhhhbebbebbbbhhhha
abnnbbbbbbbbbnnnbbbnnbhhhhhnnbbbffbbdbbbbcbbbbbbbffffbbbbbhhhhhhhhhhhbbbbbhhhhhhhhhhhbbbbbbbhhhhhhha
abbnnbbbbbggbbbnbbbbnnbhhhhbbbbbfbbbbbbbbbbbbebbbbbbfbbbbbbhhhhhhhhhhbbbbbbhhhhhhhhhbbbbbbbhhhhhhhha
abbbnnbbbbggbbbbbbzbbnbbjhhbqbbbfbbbbnbhhhhhhheebbbbffbbbbbbhhhhhhhhbbbbEbbbhhhhhhbbbbhhhbhhhhhhhhha
afffffffffggffffbbbbbbbbbbbqbbdbfbbbnnhhhhhhhhhhenbbbfbbbbbbbhhhhhhhbbbbbbbbbhhhhbHbbhhhhbhhhhhhhhha
abbbbbbbbbggbbbffffbbbbbbbbbbbbffbbbnbhhhhhhhhhhhnnbbfbbbbbbbcbhhhhhbbzbbmbbbbbbbbbbbhhhhbbhhhhhhhha
abbbbbbbbbggbbbkbbfffffffbbbbbbfbbHbnhhhhhhhhhhhhhnbbffbbbbbbbbbbbbbbbbbbbbbbbbbbbbbhhhhhbbbbbbhhhha
abbbbbbbbbbbbbbbbbbbbbbbffbbbbbfbbbbbhhhhhhhhhhhhhnnbbfbbcbbbbHbbbbbbbbbbbbbbbbbbbbhhhhhhbbbbbbhhhha
abbbkbbbbbbbkbbbbbbbbbbbbfffbbbfbbbbbhhhhhhhhhhhhhbbbbfbbbbbbbbbbbbbbbbbbbbibbbbbbhhhhhhhhbbbhhhhhha
abbbbbbbbbbbbbbjbbbbbbbEbbbfffffbbbbbbhhhhhhhhhhhhbbbbfbbbbbbbbbbbbcbbbbkbbbbbbjbbhhhhhhhhhhhhhhhhha
abbbnbnnnbbbbbbbbbbbbbbbbbbbbffbbbbbnnbhhhhhhhhhhbJzbbfbbbbbbbbbbbbbbbbbbbbbbbbbbbhhhhhhhhhhhhhhhhha
abbnnbbnnbbkbbbbbbbibbkbbbbbbbffbbbcbnnnhhhhhhhhhbbbbbfbbbbbKbKbbbhhhhhhhbbbbbbbbbhhhhhhhhhhhhhhhhha
abbnbbbnbbbbbbbbbbbbbbbbbbbbbbbfbbbbbbbnbhhhhhhhbJbbbffbbbbbbKbbhhhhhhhhhbbbbbebbbbhhhhhhhhhhhhhhhha
abbbbibbbbmbbbnnbbbbbbbbbdbbbbbffbbbjeeebbbbhhhbbbbbffbbbbbbbbbhhhhhhhhhhhbbbbbbbbbhhhhhhhhhhhhhhhha
abbbbbbbbbbbbbbnnbbbbbbbbbbbbbbbffbbbbbbbbbbbbbbbbbbfbbbbbbbbbhhhhhhhhhhhhbbebbbbbebhhhhhhhhhhhhhhha
abbbbbbbbjbbbbbknbibbnbbbbbbbbbbbffbbbbbbbbkbbbcbbfffbbbbbbbbhhhhhhhhhhhhhbbbnnnbbbbbhhhhhhhhhhhhhha
abbbbbbbbbbbbbbbnbbbbbbbbbibbbbbbbfffffffffffffffffbbbbbbbbbbhhhhhhhhhhhhhnnnnnnbbcbbbbhhhhhhhhhhhha
abbbcbbbbbbbbbbbbbbbbbbbbbbbbbbbbbbfbbbbbbbbbbbbbbbbbbbbbbbcbhhhhhhhhhhhhbnnbbbbbbbbbebbhhhhhhhhhhha
abbbbbbbbbbbibbbbbbbbbcbbbbbbbbbbbbffbbbbbhhhhbbbbbbbbbbibbbbhhhhhhhhhhhhnnbibbbbbbbbbbehhhhhhhhhhha
abbbcbbbbcbbbbbbbbbbDbbbbbbnnbbbbbbbfbbbbhhhhhhbbbdbbbbbbbbbbhhhhhhhhhhhennbbbcbbebnnbbbhhhhhhhhhhha
abbbbbnbbbbbbdbbbebbbbbbbbnnnnbbbbmbffbbbhhhhhhbbbbbbbbbbbbbbbhhhhhhhhhbenbbbbbbbbbnnnbbhhhhhhhhhhha
abnnbbbbbbbbbbbbbbkbbbbbbbbbnnbbbbbbbfbbbhhhbbbbbbbbbbbbbbbbbbhhhhhhhhbbbbbeebDbbbbbbnnbhhhhhhhhhhha
abbnnbbbebbcbbbbbbbbbnnnbbbbbnbbbbbbbfbbbbbbbbbbbbbbbbbbjbbbbbhhhhhhhhbbcbbbebbbbibbnnnbhhhhhhhhhhha
abbbbbbbbbbbbbnnbbbbbnnnbbcbbbbbbggggggggbbbbbeeebibbbEbbbbbbbhhhhhhhhbbbbbbbbbbbbbennbbhhhhhhhhhhha
abbbbbbbbbbbbbbbkbbdbnbbbbbbbbbbbggggggggbbbbebebbnnnbbbbbbbbbhhhhhhhbbbbjbbbbbbbbbbbbbhhhhhhhhhhhha
abbbbbbcbbbdbbjbbbbbbnbebbbbbbbbbbbbbffbbbbbbbbbnnnbbbbbbbbdbbhhhhhhhbbbbbbnnnnnnbbbbbbhhhhhhhhhhhha
abdbbbbbbbbbbbbbbbbbbbbbbbbbbbbbdbbbbfbbkbbbbbbnnbbhhhhhbbbbbbhhhhhhhhbbdbnnnnnnnnbbcbhhhhhhhhhhhhha
abbbbbbbbbbbbbbbbbbkbbbbbbbbbbbbbbbfffbbbbbbbbcbbhhhhhhhhhbbbbhhhhhhhhhbbbbnnnnnbbbbbhhhhhhhhhhhhhha
abbbbbbbbnnbbbbbbbbbbbbbbbbbbbbbbfffbbbbbbbbkbbhhhhhhhhhhhbbbbhhhhhhhhhhbbbbLnnbbbbhhhhhhhhhhhhhhhha
abnbbibbbnnnnbbbbebbbbbbbbdbbbbfffbbbbbbkbbbbhhhhhhhhhhhhhbbbbhhhhhhhhhhhhhbbbbhhhhhhhhhhhhhhhhhhhha
abnnbbebbnnnnbbbbbbbbbebbbbfffffbbbbkbbbbbbbbhhhhhhhhhhhhhbbbbhhhhhhhhhhhhhhhhhhhhhhhhhhhhhhhhhhhhha
abnnbbbbbnbbbbbbbbbbbbbfffffbbbbbbbbkbbbbbebbbhhhhhhhhhbbbbbbhhhhhhhhhhhhhhhhhhhhhhhhhhhhhhhhhhhhhha
abbnbbbbbbcbbbibbbbbbfffbbbbbbbbbbbbbbibbbbbbbbbbbbbbbbbbbbbbhhhhhhhhhhhhhhhhhhhhhhhhhhhhhhhhhhhhhha
abbbdbbbbbbbbbbbbbffffbbbbbebbbebbbbbbbbcbhhhbbbbbbbbbbbebbbhhhhhhhhhhhhhhhhhhhhhhhhhhhhhhhhhhhhhhha
abbbbbbbbbbbbbbbfffbbbbbebbbebkbbbbbkbbbbhhhhhbbbbcbebbbbbbhhhhhhhhhhhhhhhhhhhhhhhhhhhhhhhhhhhhhhhha
abbbbbbbbbbbbbbffbbbbnbbbbbbbbbbbbbbbbbbhhhhhhhhbbbbbbeebbhhhhhhhhhhhhhhhhhhhhhhhhhhhhhhhhhhhhhhhhha
abbbbbbbbbbebbffbbbbbnnbbebbbbbnnbbbbbhhhhhhhhhhhhbbbbbbbhhhhhhhhhhhhhhhhhhhhhhhhhhhhhhhhhhhhhhhhhha
abbbnnbbbbbbbbfbbdbbbennbbbbibbnbbbbbhhhhhhhhhhhhhhbbbbbhhhhhhhhhhhhhhhhhhhhhhhhhhhhhhhhhhhhhhhhhhha
abbnnbbbcbbbbbfbbbbbbbbnnbbbbbnnbbbbhhhhhhhhhhhhhhhhhbbhhhhhhhhhhhhhhhhhhhhhhhhhhhhhhhhhhhhhhhhhhhha
abbbbbbbbbbbbbffbbbebbbbbbbbbbbbbbbhhhhhhhhhhhhhhhhhhhhhhhhhhhhhhhhhhhhhhhhhhhhhhhhhhhhhhhhhhhhhhhha
abbbbbbbbbbbbbbffbbbbbbbbbbbbbbbbbbhhhhhhhhhhhhhhhhhhhhhhhhhhhhhhhhhhhhhhhhhhhhhhhhhhhhhhhhhhhhhhhha
aaaaaaaaaaaaaaaaaaaaaaaaaaaaaaaaaaaaaaaaaaaaaaaaaaaaaaaaaaaaaaaaaaaaaaaaaaaaaaaaaaaaaaaaaaaaaaaaaaaa
"}
