"a" = (/turf/unsimulated/hellwall,/area/space)
"b" = (/turf/simulated/floor/helldirt,/area/space)
"c" = (/obj/structure/flora/ausbushes/hellgrass3,/turf/simulated/floor/helldirt,/area/space)
"d" = (/obj/structure/flora/ausbushes/hellgrass2,/turf/simulated/floor/helldirt,/area/space)
"e" = (/obj/structure/flora/ausbushes/hellgrass,/turf/simulated/floor/helldirt,/area/space)
"f" = (/turf/unsimulated/wall/supermatter/hell,/area/space)
"g" = (/turf/simulated/floor/hellslate,/area/space)
"h" = (/turf/unsimulated/mineral,/area/space)
"i" = (/obj/structure/flora/tree/hell,/turf/simulated/floor/helldirt,/area/space)
"j" = (/obj/structure/flora/tree/plant,/turf/simulated/floor/helldirt,/area/space)
"k" = (/obj/item/remains/human,/turf/simulated/floor/helldirt,/area/space)
"l" = (/obj/item/remains/mouse,/turf/simulated/floor/helldirt,/area/space)
"m" = (/obj/item/remains/xeno,/turf/simulated/floor/helldirt,/area/space)
"n" = (/obj/structure/flora/ausbushes/hellgrass4,/turf/simulated/floor/helldirt,/area/space)

(1,1,1) = {"
aaaaaaaaaaaaaaaaaaaaaaaaaaaaaaaaaaaaaaaaaaaaaaaaaaaaaaaaaaaaaaaaaaaaaaaaaaaaaaaaaaaaaaaaaaaaaaaaaaaa
ahhhhhhhhhhhhhbbffbbbbbbbbbbbbbbbbhhhhhhhhhhhhhhhhhhhhhhhhhhhhhhhhbbbbbbbbbbbbbbbbbbhhhhhhhhhhhhhhha
ahhhhhhhhhhhhhbbbffbbibbbbbbbbbbbbhhhhhhhhhhhhhhhhhhhhhhhhhhhhhhhhbbbbbbbbbbnnnnnnnbhhhhhhhhhhhhhhha
ahhhhhhhhhhhhhbcbbfbbbbjbbhhhbebbbbhhhhhhhhhhhhhhhhhhhhhhhhhhhhhhbbbbbbbbnnnnnnnnnnbhhhhhhhhhhhhhhha
ahhhhhhhhhhhhhbbbbfffbbbhhhhhhbbdbbhhhhhhhhhhhhhhhhhhhhhhhhhhhhhhbbbbbbbcbbbnnnnnnnhhhhhhhhhhhhhhhha
ahhhhhhhhhhhhhbbbbbbffbchhhhhhhbbbbhhhhhhhhhhhhhhhhhhhhhhhhhhhhbbbbbeebbbbbbbbbnnbhhhhhhhhhhhhhhhhha
ahhhhhhhhhhhhhhbibdbbfbbhhhhhhhbbbbbhhhhhhhhhhhhhhhhhhhhhhhhhhbbbeeeebhhhhbbbbbbbbhhhhhhhhhhhhhhhhha
ahhhhhhhhhhhhhhkbbbbbfbbbhhhhhbbbbbbhhhhhhhhhhhhhhhhhhhhhhhhhbbbeeebehhhhhhbbcbbbbhhhhhhhhhhhhhhhhha
ahhhhhhhhhhhhhhbbnnnbfbkbbhhbbnbibbbhhhhhhhhhhhhhhhhhhhhhhhhhbbbeebbhhhhhhhbbbbbbbbhhhhhhhhhhhhhhhha
ahhhhhhhhhhhhhbbnnnnbfbbebbbbnnbbbbbbhhhhhhhhhhhhhhhhhhhhhhhhbbbbbbhhhhhhhhbbbbbbbbhhhhhhhhhhhhhhhha
ahhhhhhhhhhhhhbbnnnnbfebbbbbbbbbbbbnbhhhhhhhhhhhhhhhhhhhhhhhbbibbbhhhhhhhbbnnnbbbbbbhhhhhhhhhhhhhhha
ahhhhhhhhhhhhbbbnnbbbfbbffffbbebcnnnbbhhhhhhhhhhhhhhhhhhhhhbbbbbbhhhhhhhbbnnnbbibcbbbhhhhhhhhhhhhhha
ahhhhhhhhhhhbbjbbbbbbffffbbffffbbnnnbbhhhhhhhhhhhhhhhhhhhhbbbbbbhhhhhhbbbnnnnbbbbbbbbbhhhhhhhhhhhhha
ahhhhhhhhhhbnnbbbbbfffbbbbbbbbffbbbbhhhhhhhhhhhhhhhhhhhhhhnnnbbhhhhhhbbbbbbeeebbbbbbbbbbhhhhbhhhhhha
ahhhhhhhhhbnnbbbbbffbbbbbjbbbbbfbbbhhhhhhhhhhhhhhhhhhhhhbnnbnbhhhhhbbbcbbbbbbebbbbbbbbnnbhhbbbbbhhha
ahhhhbhhhbnnbbbibbfbbbbbbbebbbbfbbbhhhhhhhhhhhhhhhhhhhhhbnbnnbhhhhbbbbbbffffffffffbbebennbbffffffffa
abbbbbbbbbnbbbbbbffbbbbfffbbibbfbbbhhhhhhhhhhhhhhhhhhhhhbnbcbhhhhbbbbbbffffffffffffbbbbbnbffbhhhbbba
abbcbbbbbbbbbcbbbfbbbbffbfbbbbffbbbbhhhhhhhhhhhhhhhhhhhhhbbbhhhhbbbbbfffffffffffffffbbibbffbhhhhbbba
abbbbbbbbbbbbbbbbfbbbbfbbbbdbbfbbbjbbhhhhhhhhhhhhhhhhhhhhbbbbhhbbbbbffffffffffffffffebbbffbhhhhhbiea
abbbbbhhhbbbbbbbbfbbbbfbbbbbbffbbbbbbbhhhhhhhbbbhhhhhhhhhbbbbbbbbbbfffffffffffffffffbbbbfbbbhhhhbbba
abbbbhhhhhhbbbkbffbbcbfbbbbbffbbbbbbbbhhhhhhbbbbbbhhhhhhbbjbbbbbbbbfffffffffffffffffbfffffbbbbbcnnba
abbbbhhhhhhbbbbbfbbbbbffbbbffbbbbbbbcbbebbbbbbcbbbhhhhhhbebbibbbbbbfffffffbbbfffffffffbbbfffffffenba
abbbhhhhhhbbbbbbfbbbbbbfffffbbbbbbkbbbbebnnnbbbbbhhhhhhheebbbbbbbbfffffffbibbfffffffbbbbhhhhhhbffffa
abbbhhhhhbbbbbfffbbbbnnnbbbbbbibbbbbbbbbnnnnnbbbhhhhhhhhebbbbbffffffffffffbbfffffffbbbbhhhhhhhhbbbba
abbbhhhhbbbbbffbffbbbbbnnnbbbbbbbbbbbbbbnnnbbbbhhhhhhhhhbbbfffffffffffffffffffffffbbbchhhhhhhhhbbbba
abbbbhhbbbbbffbbbffbbbbbbnbbbfffffffffbbbbbbbbbhhhhhhhhbbbffffffbbbfffffffffffffffbbbbhhhhhhhhhbbbba
abbbbbbbbbbffbffbbfbbbhhbbbbffbbbbbbbffffffbbbbhhhhhhbbbbbffffbbbbkbffffffffffffffbebbhhhhhhhhhbbbba
abbkbbbbbbbfbbfffbfbbhhhhbbffbbbbbbbbbbbbbffbbbbhhhhbbbbbffffbbbbbbbbffffffffffffffbnnbhhhhhhhhbbbba
abbbbcbbibbfbbfbfbfbhhhhhbbfbbnnbbbbbbbbibbffbbbbbbbbbbbbfffbbbbjbibbbbfffffffffffffbnnbhhhhhhhbbbba
abbbbbbbbbbfbbfbbbfbhhhhhbbfbbnbbjbbnnbbbbbbffbbbbbbbbbbbfffbbcbbbbbbbbbbbbbbbffffffbbnbbhhhhhhbcbba
abbbbbbbbbbfbbfffffbbhhhbbbfbbbbbbbnnbbbeebbbffbbbbbbbbbfffbbbbbbbhhhhhbbbbbbbbffffffbnnbbhhhhbbbbba
abbbbbbhhhbffbkbffbbnbhhbbbfbbbbcbnnffffbbbbbbfffbbbbfffffbeebbbhhhhhhhhhbbbbbbfffffffbbbbbbbbbbbeba
abbbbbhhhhhbfbbbbbbbnnbbbbbfbbibbbbffbbffbbkbbbbfffffffffbbbeebbhhhhhhhhhhhbbbbbfffffffbbbbbbbibbnba
abbbbhhhhhhbffbbbbcbbnbbbdbfbbbbbbffbbbbffbbcbbbffffbbbbbbbbbbbbhhhhhhhhhhhhebbbbfffffffbbbbbbbnnnba
abbbbhhhhhbbbfbbbbbbbbbbbbbffbbnnbfbbbjbbfbbbbbbbfbbbnnbbbbibbbbbhhbbbbbbhhhhebbbbffffffffbbbennnnba
abbbbbjhhbbbffffffffbbbbbbbbffbbbbbbbbbbffbbbbbbbfbnnnnnnnbbbbbbbhhbbbbbbbhhhhebbbbffffffffbbbnnnnba
abbbbbbbbbfffbbbbbbffbnbbnbbbfffbbbbbbbffbbbbbbbbfbnnnnnnnbbbbbbbbeebbebbbbhhhebbbbbfffffffffbbennba
abbbbbbbbffbbbbbbbbbffbbbnbbbbbfffbbbfffbbbbbbbibfbbbbbbnnbbbibbbbbeeeebbbbbhhbbbbbbbfffbbfffffffbba
abbicbbbbfbbbbfffffbbfbbbbbbbbbbbfffffbbbbbbbbbbffbbcbbbbbbbbbbbbbbbeebbbbbhhhbbjbbbbfffbbbbbffffffa
abbbbbbbffbbbbfbbbfbbffbffffbbbbbfbbbbhhhhbbbbbbfbbbbbbbbbbbbbbbbbbbebbbbbbhhhbbbbbbffffbbbkbbbebbba
abbbbbbbfbbbbbfbbbfbbbfffbbffbbnbfbbhhhhhhbbbbbgggbbbbebbjbbbbbkbbbbbbbbbbhhhhbbbbkbfffbbjbbbbbbbbba
abbbbbbbfbbbbbffcbfbbbffbbbbfbbnbfbhhhhhhbbbbbbgggbbbeebbbbbbbbbbbbbbbbbbhhhhbbbibbbfffbebbhhhhhhbha
abbbbbbbffbbibbfbbfbbkfbbbbffbbnbfbhhhhbbbbbbbbbffbbeeeebbbbbbbbbbbbbbhhhhhhhbbbbbbbfffbcehhhhhbhbha
abbbbbbbbfbbbbbfbbfbbbfbbfffbbbbbfbhhbbbbbbbbbbbfbbbbeebcbbbbbbbbbbhhhhhhhhhbbbbbbffffbebhhhhbbbbbha
affbbnnbbfbbbbbfbbfbibffbbbbbbbbffbbbbbbbbbbbbbffbbbbebbbbbbbbbbbbbhhhhhhhbbbbbbbfffffbbhhhhbbbbbbha
abfbbnnnbffbbbffbbfbbbbfbbbbbbfffbbbbbdbbhhhhbbfbbbbbbbbbbbbbbcbbbhhhhhhhbebebbffffffbbhhhhhhbbeebha
abffbnnnbbfffffbbbfbbbbfffbbfffbbbbbbbbbhhhhhbbfbbbbbbbhhhbbbbbbbbhhhhhhbebbbffffbbbbnbhhhhhhbbebbha
abbfbbbjbbbbbhhhbbfbhhbbbffffbbbbbbbbbbbhhhhhbbfbbbbbhhhhhhhbbbbbbbbhhbbbbbffffbbbbbbnbhhhhhhbbbbbha
abbffbbbcbbbhhhhbbfhhhbbbbbbbbbbbbbjbbbhhhhhhbbfbbbhhhhhhhhhbbbbbbebbbbbbbffffbbnnnbbbhhhhhhhhbbbhha
abbbffbbbbbhhhhbbffhhhbbbbbbbbbnbbbbbbbhhhhhbbffbbbhhhhhhhhhbbbbeebbbbbbbfffbbbnnnebbchhhhhhhhhbbhha
abbbbfbbbbbhhhbbffhhhhbbbbbbbbbbbbbbbcbhhhhbbbfbbbbhhhhhhhhhbcbeebbbcbbbffffbbennbbbbbbbbhhhhhhhbhha
abbbbffbbbbbhhbffhhhhbbbbbhhhhhbnbbbbbbhhhhbbffbbbbhhhhhhhhhbbbeebbebbbffffbbbbbbebbbbebbbhhhhhhbhha
abbbbbffffffffffhhhhbbbhhhhhhhhbbbbbbbbbhhbbffbbbnbhhhhhhhhhbbbebibbbbbfffbbbjbbhhhhhbbbbbbhhhhhbbha
abbbbbbbbbhhhhhhhhhbbbhhhhhhhbbbbbbbbbbbbbfffbbbbnnbhhhhhhhhhbbbbbbbbbbffbbebbbhhhhhhhbebbbhhhhhbbha
abbbkbbbbbhhhhhhhhbbbhhhhhhhbbbbbbbbbbbbbffbbbbbbbnbbhhhhhhhhhhbbbbbbbffbbbbbbhhhhhhhhhbbbbhhhhhbbha
abbbbbbbbbbhhhhhbbbbbhhhhhhbbnbbbbbbbbbbffbbbbbbbbbbbbbbbhhhhhhhhbbebbffbbibebhhhhhhhhhbbbbbbbbbbbha
abbbbbibbbbbbbbbbbbbbhhhhhbnnnnbbbbffffffffffffbblbcbbbbbhhhhhhhhhhbbbbbbbbcbbhhhhhhhhhbbeebbbbbbbha
abbbbbbbbbbbbbbbbbbbbhhhhhnnnnbbbbffbbbbbbbbbbfffbbbbbbbbhhhhhhhhhhhbbbbbbbbbhhhhhhhhhbbbbbbbbbbbhha
abbbbbbbbbbbcnnbbbbnbbhhhhnbnbbbbffbbbbbbbbbbbbbffbbbbbbbhhhhhhhhhhhhbbbbbbhhhhhhhhhhhbebbebbbbhhhha
abnnbbbbbbbbbnnnbbbnnbhhhhhnnbbbffbbdbbbbcbbbbbbbffffbbbbbhhhhhhhhhhhbbbbbhhhhhhhhhhhbbbbbbbhhhhhhha
abbnnbbbbbggbbbnbbbbnnbhhhhbbbbbfbbbbbbbbbbbbebbbbbbfbbbbbbhhhhhhhhhhbbbbbbhhhhhhhhhbbbbbbbhhhhhhhha
abbbnnbbbbggbbbbbbbbbnbbjhhbbbbbfbbbbnbhhhhhhheebbbbffbbbbbbhhhhhhhhbbbbbbbbhhhhhhbbbbhhhbhhhhhhhhha
afffffffffggffffbbbbbbbbbbbbbbdbfbbbnnhhhhhhhhhhenbbbfbbbbbbbhhhhhhhbbbbbbbbbhhhhbbbbhhhhbhhhhhhhhha
abbbbbbbbbggbbbffffbbbbbbbbbbbbffbbbnbhhhhhhhhhhhnnbbfbbbbbbbcbhhhhhbbbbbmbbbbbbbbbbbhhhhbbhhhhhhhha
abbbbbbbbbggbbbkbbfffffffbbbbbbfbbbbnhhhhhhhhhhhhhnbbffbbbbbbbbbbbbbbbbbbbbbbbbbbbbbhhhhhbbbbbbhhhha
abbbbbbbbbbbbbbbbbbbbbbbffbbbbbfbbbbbhhhhhhhhhhhhhnnbbfbbcbbbbbbbbbbbbbbbbbbbbbbbbbhhhhhhbbbbbbhhhha
abbbkbbbbbbbkbbbbbbbbbbbbfffbbbfbbbbbhhhhhhhhhhhhhbbbbfbbbbbbbbbbbbbbbbbbbbibbbbbbhhhhhhhhbbbhhhhhha
abbbbbbbbbbbbbbjbbbbbbbbbbbfffffbbbbbbhhhhhhhhhhhhbbbbfbbbbbbbbbbbbcbbbbkbbbbbbjbbhhhhhhhhhhhhhhhhha
abbbnbnnnbbbbbbbbbbbbbbbbbbbbffbbbbbnnbhhhhhhhhhhbbbbbfbbbbbbbbbbbbbbbbbbbbbbbbbbbhhhhhhhhhhhhhhhhha
abbnnbbnnbbkbbbbbbbibbkbbbbbbbffbbbcbnnnhhhhhhhhhbbbbbfbbbbbbbbbbbhhhhhhhbbbbbbbbbhhhhhhhhhhhhhhhhha
abbnbbbnbbbbbbbbbbbbbbbbbbbbbbbfbbbbbbbnbhhhhhhhbbbbbffbbbbbbbbbhhhhhhhhhbbbbbebbbbhhhhhhhhhhhhhhhha
abbbbibbbbmbbbnnbbbbbbbbbdbbbbbffbbbjeeebbbbhhhbbbbbffbbbbbbbbbhhhhhhhhhhhbbbbbbbbbhhhhhhhhhhhhhhhha
abbbbbbbbbbbbbbnnbbbbbbbbbbbbbbbffbbbbbbbbbbbbbbbbbbfbbbbbbbbbhhhhhhhhhhhhbbebbbbbebhhhhhhhhhhhhhhha
abbbbbbbbjbbbbbknbibbnbbbbbbbbbbbffbbbbbbbbkbbbcbbfffbbbbbbbbhhhhhhhhhhhhhbbbnnnbbbbbhhhhhhhhhhhhhha
abbbbbbbbbbbbbbbnbbbbbbbbbibbbbbbbfffffffffffffffffbbbbbbbbbbhhhhhhhhhhhhhnnnnnnbbcbbbbhhhhhhhhhhhha
abbbcbbbbbbbbbbbbbbbbbbbbbbbbbbbbbbfbbbbbbbbbbbbbbbbbbbbbbbcbhhhhhhhhhhhhbnnbbbbbbbbbebbhhhhhhhhhhha
abbbbbbbbbbbibbbbbbbbbcbbbbbbbbbbbbffbbbbbhhhhbbbbbbbbbbibbbbhhhhhhhhhhhhnnbibbbbbbbbbbehhhhhhhhhhha
abbbcbbbbcbbbbbbbbbbbbbbbbbnnbbbbbbbfbbbbhhhhhhbbbdbbbbbbbbbbhhhhhhhhhhhennbbbcbbebnnbbbhhhhhhhhhhha
abbbbbnbbbbbbdbbbebbbbbbbbnnnnbbbbmbffbbbhhhhhhbbbbbbbbbbbbbbbhhhhhhhhhbenbbbbbbbbbnnnbbhhhhhhhhhhha
abnnbbbbbbbbbbbbbbkbbbbbbbbbnnbbbbbbbfbbbhhhbbbbbbbbbbbbbbbbbbhhhhhhhhbbbbbeebbbbbbbbnnbhhhhhhhhhhha
abbnnbbbebbcbbbbbbbbbnnnbbbbbnbbbbbbbfbbbbbbbbbbbbbbbbbbjbbbbbhhhhhhhhbbcbbbebbbbibbnnnbhhhhhhhhhhha
abbbbbbbbbbbbbnnbbbbbnnnbbcbbbbbbggggggggbbbbbeeebibbbbbbbbbbbhhhhhhhhbbbbbbbbbbbbbennbbhhhhhhhhhhha
abbbbbbbbbbbbbbbkbbdbnbbbbbbbbbbbggggggggbbbbebebbnnnbbbbbbbbbhhhhhhhbbbbjbbbbbbbbbbbbbhhhhhhhhhhhha
abbbbbbcbbbdbbjbbbbbbnbebbbbbbbbbbbbbffbbbbbbbbbnnnbbbbbbbbdbbhhhhhhhbbbbbbnnnnnnbbbbbbhhhhhhhhhhhha
abdbbbbbbbbbbbbbbbbbbbbbbbbbbbbbdbbbbfbbkbbbbbbnnbbhhhhhbbbbbbhhhhhhhhbbdbnnnnnnnnbbcbhhhhhhhhhhhhha
abbbbbbbbbbbbbbbbbbkbbbbbbbbbbbbbbbfffbbbbbbbbcbbhhhhhhhhhbbbbhhhhhhhhhbbbbnnnnnbbbbbhhhhhhhhhhhhhha
abbbbbbbbnnbbbbbbbbbbbbbbbbbbbbbbfffbbbbbbbbkbbhhhhhhhhhhhbbbbhhhhhhhhhhbbbbbnnbbbbhhhhhhhhhhhhhhhha
abnbbibbbnnnnbbbbebbbbbbbbdbbbbfffbbbbbbkbbbbhhhhhhhhhhhhhbbbbhhhhhhhhhhhhhbbbbhhhhhhhhhhhhhhhhhhhha
abnnbbebbnnnnbbbbbbbbbebbbbfffffbbbbkbbbbbbbbhhhhhhhhhhhhhbbbbhhhhhhhhhhhhhhhhhhhhhhhhhhhhhhhhhhhhha
abnnbbbbbnbbbbbbbbbbbbbfffffbbbbbbbbkbbbbbebbbhhhhhhhhhbbbbbbhhhhhhhhhhhhhhhhhhhhhhhhhhhhhhhhhhhhhha
abbnbbbbbbcbbbibbbbbbfffbbbbbbbbbbbbbbibbbbbbbbbbbbbbbbbbbbbbhhhhhhhhhhhhhhhhhhhhhhhhhhhhhhhhhhhhhha
abbbdbbbbbbbbbbbbbffffbbbbbebbbebbbbbbbbcbhhhbbbbbbbbbbbebbbhhhhhhhhhhhhhhhhhhhhhhhhhhhhhhhhhhhhhhha
abbbbbbbbbbbbbbbfffbbbbbebbbebkbbbbbkbbbbhhhhhbbbbcbebbbbbbhhhhhhhhhhhhhhhhhhhhhhhhhhhhhhhhhhhhhhhha
abbbbbbbbbbbbbbffbbbbnbbbbbbbbbbbbbbbbbbhhhhhhhhbbbbbbeebbhhhhhhhhhhhhhhhhhhhhhhhhhhhhhhhhhhhhhhhhha
abbbbbbbbbbebbffbbbbbnnbbebbbbbnnbbbbbhhhhhhhhhhhhbbbbbbbhhhhhhhhhhhhhhhhhhhhhhhhhhhhhhhhhhhhhhhhhha
abbbnnbbbbbbbbfbbdbbbennbbbbibbnbbbbbhhhhhhhhhhhhhhbbbbbhhhhhhhhhhhhhhhhhhhhhhhhhhhhhhhhhhhhhhhhhhha
abbnnbbbcbbbbbfbbbbbbbbnnbbbbbnnbbbbhhhhhhhhhhhhhhhhhbbhhhhhhhhhhhhhhhhhhhhhhhhhhhhhhhhhhhhhhhhhhhha
abbbbbbbbbbbbbffbbbebbbbbbbbbbbbbbbhhhhhhhhhhhhhhhhhhhhhhhhhhhhhhhhhhhhhhhhhhhhhhhhhhhhhhhhhhhhhhhha
abbbbbbbbbbbbbbffbbbbbbbbbbbbbbbbbbhhhhhhhhhhhhhhhhhhhhhhhhhhhhhhhhhhhhhhhhhhhhhhhhhhhhhhhhhhhhhhhha
aaaaaaaaaaaaaaaaaaaaaaaaaaaaaaaaaaaaaaaaaaaaaaaaaaaaaaaaaaaaaaaaaaaaaaaaaaaaaaaaaaaaaaaaaaaaaaaaaaaa
"}
